Mm, Mm, Mm, Hh, Hh, Hh, Hh, Hh, Hh, Gg, Gs^Fds, Gg, Gg, Gg, Gs^Fds, Gg, Gg, Gg, Gs^Fds, Gg, Rd, Rd, Gg, Gg, Gg, Gg, Gg, Gg, Gs^Fds, Gs^Fds
Mm, Mm, Mm, Hh, Hh, Hh, Hh, Hh, Hh, Gg, Gs^Fds, Gg, Gg, Gg, Gs^Fds, Gg, Gg, Gg, Gs^Fds, Gg, Rd, Rd, Gg, Gg, Gg, Gg, Gg, Gg, Gs^Fds, Gs^Fds
Mm, Mm, Hh, Hh, Hh, Hh, Gg, Gg, Gs^Fds, Gg, Gg, Gs^Fds, Gs^Fds, Gg, Gg, Gs^Fds, Gs^Fds, Gg, Gg, Gs^Fds, Rd, Gg, Gg, Gg, Gg, Gg, Gg, Gs^Fds, Gg, Gs^Fds
Hh^Fds, Hh^Fds, Gs^Fds, Gg, Gg, Gg, Re^Gvs, Re^Gvs, Re^Gvs, Gs^Fds, Gs^Fds, Gg, Gg, Gs^Fds, Gs^Fds, Gg, Gg, Gs^Fds, Rd, Rd, Ce, Ce, Gg, Gg, Gg, Gg, Gs^Fds, Gg, Gs^Fds, Gs^Fds
Gs^Fds, Gs^Fds, Gs^Fds, Gg, Re^Gvs, Re^Gvs, Re^Gvs, Re^Gvs, Rd, Rd, Rd, Gs^Fds, Gs^Fds, Gg, Gg, Gs^Fds, Gs^Fds, Gg, Rd, Ce, 1 Ke, Ce, Gg, Gg, Gs^Fds, Gg, Gs^Fds, Gs^Fds, Gs^Fds, Gs^Fds
Rd, Rd, Rd, Rd, Rd, Rd, Rd, Rd, Re^Gvs, Re^Gvs, Re^Gvs, Rd, Re^Gvs, Gs^Fds, Gs^Fds, Gg, Rd, Rd, Re^Gvs, Re^Vh, Re^Gvs, Gg, Gg, Gg, Gg, Gg, Gs^Fds, Gs^Fds, Gs^Fds, Gg
Gg, Gg, Gg, Gg, Gg, Re^Vh, Re^Gvs, Re^Gvs, Re^Gvs, Re^Gvs, Re^Gvs, Rd, Rd^Vwm, Re^Gvs, Re^Gvs, Rd, Re^Gvs, Re^Gvs, Re^Gvs, Re^Gvs, Re^Gvs, Re^Gvs, Gg, Gs^Fds, Gg, Gs^Fds, Gs^Fds, Gg, Gs^Fds, Gs^Fds
Gg, Gg, Hh^Fds, Gg, Hh, Gg, Hh, Re^Gvs, Re^Vh, Re^Gvs, Gg, Rd, Rd, Re^Gvs, Re^Gvs, Rd, Re^Gvs, Re^Gvs, Re^Gvs, Re^Gvs, Gg, Gg, Gs^Fds, Gg, Gs^Fds, Gg, Gs^Fds, Gs^Fds, Gs^Fds, Gs^Fds
Gs^Fds, Gs^Fds, Hh^Fds, Hh^Fds, Hh, Hh, Hh, Gg, Gg, Gg, Ww, Ww, Ww, Rd, Rd, Rd, Re^Vh, Re^Gvs, Gg, Gg, Gg, Gs^Fds, Gs^Fds, Gs^Fds, Gg^Vh, Gg, Gs^Fds, Gs^Fds, Gs^Fds, Gs^Fds
Gs^Fds, Gs^Fds, Gs^Fds, Hh, Ww, Ww, Ww, Gg, Ss, Ww, Ds, Ds, Ww, Rd, Rd, Gs, Ww, Gg, Gg, Ss, Ss, Ss, Ww, Ww, Ww, Gs^Fds, Hh, Hh, Hh, Hh
Gg, Gg, Ss, Ww, Ss, Ss, Ww^Vm, Wwf, Ww, Ww, Gg, Ds, Ww, Ch, Wwf, Ww, Ds, Ww, Ww, Ww, Ww, Ww, Gs^Fds, Gs^Fds, Gs^Fds, Ww, Gg, Hh, Hh, Hh
Gs^Fds, Gs^Fds, Ww, Ww, Ss, Ss, Gg, Ww, Gg, Gg, Gg, Gs^Fds, Wwf, Ww, Rd, Rd, Gg, Ds, Gg, Gg, Gg, Gs^Fds, Gs^Fds, Gs^Fds, Gs^Fds, Ww, Gs^Fds, Gs^Fds, Ww, Ww
Ss, Ss, Ww, Ss, Ss, Ss, Gg, Gs^Fds, Gs^Fds, Gg, Gg, Gg, Gg, Rd, Rd, Re^Vh, Re^Gvs, Gg, Gg, Gg, Gg, Gs^Fds, Gg^Vl, Gs^Fds, Gs^Fds, Ww, Ww, Ww, Ss, Hh
Ss, Ss, Ww, Ss, Ss, Gg, Gg, Gs^Fds, Gg, Gg, Rd, Gg, Rd, Rd, Rd, Re^Gvs, Hh, Re^Gvs, Gs^Fds, Gg, Gg, Gg, Gg, Gs^Fds, Gs^Fds, Gs^Fds, Gg, Ss, Gg, Hh
Ww, Ww, Ss, Ss, Gg, Ss, Rd, Gg, Rd, Rd, Gs, Rd, Re^Gvs, Re^Vh, Rd, Gs^Fds, Hh, Hh, Gg, Gg, Gg, Gg, Gg, Gg, Gg, Gs^Fds, Gg, Ss, Gg, Gg
Gg, Gg, Gg, Gg, Ss, Rd, Ss, Rd, Gg, Gs^Fds, Gs^Fds, Re^Gvs, Re^Gvs, Re^Gvs, Rd, Hh, Hh, Gg, Gg^Es, Gg, Gs^Fds, Gg, Gg, Gg, Hh, Gg, Hh, Gg, Gs^Fds, Gg
Gg, Gg, Rd, Ss, Rd, Ss^Vhs, Ss, Ss, Ss, Gs^Fds, Gg, Gs, Gg, Hh, Rd, Gg, Gg, Gg, Gg, Gg, Hh, Gs^Fds, Hh, Gg, Hh, Hh, Hh, Gg, Gg, Gs^Fds
Rd, Rd, Gg, Rd, Gg, Gg, Ss, Ss, Ss, Ss, Gs^Fds, Gg, Gg, Gg, Hh, Rd, Gs^Fds, Gg, Gs^Fds, Gg, Hh, Hh, Hh, Hh, Mm, Hh, Mm, Hh, Hh^Fms, Gs^Fds
Gg, Gg, Ss, Ss, Ss, Ss, Ss, Ss, Ss, Ss, Gs^Fds, Gg, Gs^Fds, Gg, Gg, Rd, Gs^Fds, Gs^Fds, Gs^Fds, Gs^Fds, Hh^Fms, Hh^Fms, Hh, Mm, Mm, Mm, Mm, Hh, Hh, Hh^Fds
Ss, Ss, Ss, Ss, Ss, Ss, Gg, Ss, Gs^Fds, Gs^Fds, Gs^Fds, Gs^Fds, Gs^Fds, Gg, Rd, Rd, Hh^Fds, Gs^Fds, Gs^Fds, Gs^Fds, Gs^Fds, Hh^Fms, Hh^Fms, Hh, Hh, Mm, Hh, Mm, Mm, Mm
Hh, Hh, Hh, Gg, Gs^Fds, Gs^Fds, Gs^Fds, Gs^Fds, Gs^Fds, Gs^Fds, Gs^Fds, Gs^Fds, Gs^Fds, Rd, Gs^Fds, Gs^Fds, Hh^Fds, Hh^Fds, Gs, Gs^Fds, Gs^Fds, Hh^Fms, Hh, Hh, Hh, Hh, Hh, Hh, Hh, Hh
Gs^Fds, Gs^Fds, Gs^Fds, Gs^Fds, Gs^Fds, Gs^Fds, Gs^Fds, Gs^Fds, Gs^Fds, Gs^Fds, Gs^Fds, Gs^Fds, Gs^Fds, Rd, Gs^Fds, Hh, Hh, Hh^Fds, Gs^Fds, Gs, Gs^Fds, Gs^Fds, Gs^Fdw, Gs^Fds, Hh, Hh^Fms, Hh^Fms, Hh, Hh^Fms, Hh
Gg, Gg, Gs^Fds, Gs^Fds, Gs^Fds, Gs^Fds, Hh, Hh, Gs^Fds, Gs^Fds, Gs^Fds, Gs^Fds, Gs^Fds, Rd, Rd, Gs^Fds, Gs^Fds, Gs^Fds, Gs^Fds, Gs^Fds, Gs^Fds, Gs^Fds, Gs^Fds, Gs^Fds, Gs^Fds, Hh, Hh^Fms, Hh^Fds, Gs^Fds, Hh^Fds
Hh, Hh, Gg, Hh, Hh^Fds, Gs^Fds, Gs^Fds, Hh, Gs^Fds, Gs^Fds, Gs^Fds, Gs^Fds, Gs^Fds, Gs, Rd, Gs^Fds, Gs^Fds, Gs^Vhr, Gs, Ce, 2 Ke, Ce, Gs^Fds, Gs^Fds, Gs^Fds, Hh^Fds, Hh^Fds, Hh^Fms, Ww, Gs^Fds
Hh, Hh, Hh, Hh^Fds, Hh^Fds, Gs^Fds, Gs^Fds, Gs^Fds, Hh, Gs^Fds, Gs^Fds, Gs^Fds, Gs^Fds, Rd, Gs^Fds, Rd, Rd, Rd, Rd, Gs^Fds, Ce, Hh, Rd, Gs^Fds, Gs^Fdw, Hh, Gs^Fds, Gs^Fds, Ww, Ww
Mm, Mm, Mm, Hh, Hh^Fds, Hh^Fds, Hh, Gg, Hh, Hh, Gs^Fds, Gs^Fds, Rd, Rd, Gs^Fds, Gs^Fds, Gs^Fds, Gs^Fds, Gs^Fds, Gs^Fds, Gs^Fds, Rd, Gs^Fds, Rd, Rd, Gs^Fds, Gs^Fds, Gs^Fds, Gs^Fds, Gs^Fds
Mm, Mm, Mm, Mm, Hh, Hh, Hh, Gs^Fds, Gg, Gs^Fds, Gs^Fds, Rd, Gs^Fds, Gs^Fds, Hh^Fds, Hh^Fds, Hh, Gs^Fds, Hh, Gs^Fds, Gs^Fds, Gs^Fds, Gs^Fds, Gs^Fds, Gs^Fds, Gs, Gs^Fds, Rd, Gs, Gs^Fds
