Aa, Aa, Aa, Cud, Rr, Xu, Uu, Xu, Xu, Xu, Xu, Xu, Xu, Xu, Xu, Xu, Xu, Xu, Xu, Xu, Xu, Xu, Xu, Xu, Xu, Xu, Xu, Xu, Xu, Xu, Xu, Xu, Xu, Xu, Wo, Xu, Xu, Xu, Xu, Xu
Aa, Aa, Aa, Cud, Rr, Xu, Uu, Xu, Xu, Xu, Xu, Xu, Xu, Xu, Xu, Xu, Xu, Xu, Xu, Xu, Xu, Xu, Xu, Xu, Xu, Xu, Xu, Xu, Xu, Xu, Xu, Xu, Xu, Xu, Wo, Xu, Xu, Xu, Xu, Xu
Cud, Cud, Rr, Aa, Rr, Uu, Uu, Uu, Uu^Em, Xu, Xu, Xu, Xu, Xu, Xu, Xu, Xu, Xu, Xu, Xu, Xu, Xu, Xu, Xu, Xu, Xu, Xu, Xu, Xu, Xu, Xu, Wo, Wo, Wo, Ww, Wo, Xu, Xu, Xu, Xu
Xu, Xu, Aa, Rr, Rr, Rr, Rr, Rr^Es, Uu, Xu, Xu, Xu, Xu, Xu, Ww, Ai, Ai, Xu, Ww, Wo, Wo, Xu, Xu, Xu, Xu, Xu, Xu, Xu, Xu, Xu, Xu, Ww, Ww, Wo, Ww, Xu, Xu, Xu, Xu, Xu
Xu, Xu, Cud, Aa, Ai, Rr^Es, Rr, Rr, Uh, Xu, Xu, Xu, Xu, Xu, Wo, Wo, Xu, Ww, Ww, Ai, Xu, Wo, Wo, Xu, Ww, Xu, Uu^Vu, Xu, Xu, Xu, Ww, Xu, Ww, Ww, Wo, Xu, Xu, Xu, Xu, Xu
Xu, Xu, Cud, Cud, Cud, 1 Kud, Rr, Rr^Es, Ai, Xu, Xu, Ai, Ai, Wo, Xu, Xu, Xu, Xu, Xu, Xu, Xu, Xu, Wo, Wo, Xu, Ww, Wo, Xu, Wo, Ww, Ww, Ww, Xu, Wo, Xu, Xu, Xu, Xu, Xu, Xu
Xu, Xu, Xu, Cud, Uu, Cud, Rr, Rr, Xu, Xu, Uu, Ww, Ww, Ww, Xu, Xu, Xu, Xu, Xu, Xu, Xu, Xu, Xu, Xu, Xu, Xu, Xu, Wo, Xu, Xu, Ww, Xu, Xu, Xu, Xu, Xu, Xu, Xu, Xu, Xu
Xu, Xu, Xu, Xu, Xu, Rr, Xu, Uu^Es, Rr, Rr, Uu, Xu, Uu^Ii, Ai, Uu, Uu, Uu^Es, Xu, Xu, Xu, Xu, Xu, Xu, Xu, Xu, Xu, Xu, Xu, Xu, Xu, Wo, Wo, Xu, Xu, Xu, Xu, Xu, Xu, Xu, Xu
Xu, Xu, Xu, Xu, Xu, Xu, Xu, Uu, Uh, Uu^Ii, Uu^Ii, Uu, Uu, Uu, Rd, Rd, Rd, Uu, Uu, Uu^Tf, Uu^Vu, Xu, Xu, Xu, Xu, Xu, Ww, Xu, Ww, Wo, Ww, Wo, Xu, Xu, Xu, Xu, Xu, Xu, Xu, Xu
Xu, Xu, Xu, Xu, Xu, Xu, Xu, Qxu, Qxu, Uh, Rd, Uu, Rd, Uu^Es, Uu^Ii, Uu, Uu, Rd, Re, Uu^Tf, Xu, Uu^Tf, Xu, Xu, Xu, Xu, Ds, Ww, Ds, Ww, Ww, Xu, Xu, Xu, Xu, Xu, Xu, Xu, Xu, Xu
Xu, Xu, Xu, Xu, Qxu, Qxu, Xu, Qxu, Xu, Xu, Uu, Rd, Uu, Uu, Qxu, Qxu, Qxu, Uu, Re, Re, Xu, Xu, Xu, Xu, Uu^Tf, Uu^Ii, Uu, Ds, Rd, Ds, Rd, Xu, Cud, Cud, 3 Kud, Xu, Xu, Xu, Xu, Xu
Xu, Xu, Xu, Xu, Qxu, Qxu, Qxu, Qxu, Qxu, Xu, Uu^Vu, Rd, Uu, Rd^Ii, Qxu, Qxu, Qxu, Uu^Tf, Re, Rr, Rr^Ii, Uu, Rr, Xu, Rr, Uu, Xu, Xu, Ww, Rd, Rd, Xu, Uu, Cud, Cud, Xu, Xu, Xu, Xu, Xu
Xu, Xu, Xu, Qxu, Qxu, Qxu, Qxu, Qxu, Qxu, Uu, Uu^Em, Uu, Qxu, Rd, Uu^Vu, Qxu, Qxu, Qxu, Xu, Uu, Uu, Uu, Uu, Rr, Uu, Uu, Xu, Ww, Xu, Xu, Ds, Uu, Uu^Vu, Uu^Tf, Xu, Xu, Xu, Xu, Xu, Xu
Xu, Xu, Xu, Xu, Xu, Xu, Xu, Qxu, Xu, Qxu, Qxu, Qxu, Qxu, Uu, Qxu, Qxu, Qxu, Xu, Xu, Rd, Rd, Xu, Xu, Uu^Tf, Uu^Vu, Xu, Ww, Ww, Xu, Ds, Ds, Uu^Es, Uu, Ss, Ss, Xu, Xu, Xu, Xu, Xu
Xu, Xu, Xu, Xu, Xu, Xu, Xu, Xu, Xu, Xu, Qxu, Qxu, Xu, Qxu, Qxu, Xu, Xu, Xu, Rd, Rd, Uu, Xu, Xu, Xu, Xu, Xu, Ww, Ww, Xu, Ds, Uh, Re, Ss, Ss, Re^Tf, Re^Tf, Xu, Xu, Xu, Xu
Xu, Xu, Xu, Xu, Xu, Xu, Xu, Xu, Xu, Xu, Xu, Xu, Xu, Qxu, Xu, Xu, Xu, Uh, Rd, Uu, Ds, Xu, Ww, Xu, Ww, Ww, Ww, Xu, Uu^Vu, Xu, Re, Re, Uu, Ss, Ss, Re, Re^Tf, Xu, Xu, Xu
Xu, Xu, Xu, Xu, Uu^Ii, Uu^Ii, Uu, Xu, Rd, Xu, Xu, Xu, Xu, Xu, Xu, Xu, Uu^Vu, Uu, Uu, Ds, Ww, Ww, Wo, Ww, Wo, Wo, Xu, Xu, Uu, Uu, Re, Re, Re, Uh, Uh, Ss, Xu, Xu, Xu, Xu
Xu, Xu, Xu, Uu, Uu, Xu, Xu, Uu, Uu, Uu^Vu, Rr, Xu, Rr, Ai, Xu, Xu, Re, Uu, Xu, Ds, Ww, Ww, Xu, Wo, Wo, Xu, Uu^Es, Uu, Re, Re, Uu^Ii, Uu, Rr, Uh, Xu, Xu, Xu, Xu, Xu, Xu
Xu, Xu, Xu, Uu^Vu, Uu^Em, Xu, Uu, Uu, Uh, Uu, Xu, Rr, Ww^Bw\, Wo, Xu, Xu, Uu, Uu^Ii, Xu, Xu, Xu, Xu, Xu, Xu, Wo, Ww, Uu, Uu, Uu, Uu, Xu, Uu, Rr, Uu, Uu^Tf, Xu, Xu, Xu, Xu, Xu
Xu, Xu, Uh, Uu, Uu, Uu, Uu^Ii, Uu, Uu, Uu, Xu, Ww, Rr, Rr, Uu, Re, Uu, Uu, Uu, Xu, Re, Uu, Uu^Ii, Uu, Ww^Bsb/, Ww^Bsb/, Wo, Xu, Ss, Xu, Xu, Xu, Uu^Tf, Rr, Rr, Xu, Uu^Vu, Xu, Xu, Xu
Xu, Xu, Uh, Uh, Uu, Cud, Xu, Cud, 4 Kud, Uu^Vu, Uu, Ww, Rr, Uu, Uu, Uu, Xu, Re, Re, Uu, Re, Re, Uu, Ds, Xu, Ww, Wo, Ss, Xu, Ss, Xu, Xu, Xu, Uu^Tf, Rr, Uu^Tf, Uu^Tf, Xu, Xu, Xu
Xu, Xu, Uu^Vu, Uu, Uh, Xu, Xu, Cud, Cud, Cud, Uu^Ii, Ww, Rr, Xu, Xu, Xu, Xu, Xu, Re, Xu, Xu, Uu, Xu, Xu, Xu, Wo, Xu, Ss, Xu, Uh, Uh, Xu, Xu, Uu^Tf, Rr, Uu^Tf, Uu, Xu, Xu, Xu
Xu, Xu, Uu, Rd, Rd, Xu, Uu^Vu, Uu^Ii, Uu, Cud, Uu, Ww, Ww, Uu^Vu, Xu, Xu, Xu, Xu, Re, Xu, Xu, Xu, Xu, Xu, Xu, Wo, Wo, Xu, Uh, Uh, Xu, Xu, Xu, Uu^Vu, Rr, Uu, Xu, Uu^Em, Xu, Xu
Xu, Xu, Xu, Uu^Tf, Ss, Uu^Tf, Uu^Tf, Uu, Uu, Uu, Re, Uu, Ds, Ww, Ww, Xu, Ds, Xu, Xu, Xu, Uh, Xu, Xu, Xu, Uu, Ww, Wo, Ww, Ww, Uu, Uu, Uu, Xu, Rr, Uu, Rd, Xu, Xu, Xu, Xu
Xu, Xu, Xu, Uu^Tf, Xu, Uu^Tf, Kud, Cud, Xu, Uh, Uh, Uu, Uu, Ds, Ds, Ds, Ds, Rd, Xu, Rd, Uu, Uu, Xu, Xu, Uu^Vu, Ww, Ww, Wo, Wo, Ww, Uu, Xu, Rd, Rr, Uu^Vu, Xu, Xu, Xu, Xu, Xu
Xu, Xu, Xu, Xu, Xu, Xu, Xu, Xu, Xu, Xu, Uh, Re, Re, Uu^Vu, Uu, Uu, Uu, Ww, Ww, Xu, Uh, Uu, Uu^Vu, Xu, Xu, Uu, Uu, Ww, Wo, Ww, Uh, Uu, Uu, Rr, Xu, Xu, Xu, Xu, Xu, Xu
Xu, Xu, Xu, Xu, Xu, Xu, Xu, Xu, Xu, Xu, Xu, Uu, Xu, Re, Re, Re, Xu, Xu, Xu, Xu, Qxu, Uu, Rr, Uu, Uh, Uh, Ww, Ww, Wo, Ww, Ww, Wo, Ss, Rr, Uh, Xu, Xu, Xu, Xu, Xu
Xu, Xu, Xu, Xu, Xu, Xu, Xu, Xu, Xu, Xu, Xu, Xu, Xu, Xu, Xu, Xu, Xu, Xu, Uh, Qxu, Qxu, Uu^Vu, Uu, Rr, Uu, Ww, Wo, Wo, Wo, Wo, Ww, Wo, Ss, Rr, Uu^Tf, Xu, Xu, Xu, Xu, Xu
Xu, Xu, Xu, Xu, Xu, Xu, Xu, Xu, Xu, Xu, Xu, Xu, Qxu, Qxu, Qxu, Xu, Uu, Uh, Rr, Uh, Uu, Uu, Cud, Rr, Uu^Ii, Ww, Wo, Wo, Wo, Wo, Ww, Ss, Rr, Rr, Uh, Xu, Xu, Xu, Xu, Xu
Xu, Xu, Xu, Xu, Xu, Xu, Xu, Xu, Xu, Xu, Xu, Xu, Qxu, Qxu, Uu, Uu^Vu, Rr, Cud, Cud, Cud, Rr, Uu, Rr, Rr, Rr, Uu, Uh, Wo, Uu^Vu, Uu, Uu^Tf, Rr, Uu, Uu, Ss, Ss, Xu, Xu, Xu, Xu
Xu, Xu, Xu, Xu, Xu, Xu, Xu, Xu, Xu, Xu, Xu, Xu, Qxu, Qxu, Uu^Tf, Rr, Cud, Cud, 2 Kud, Cud, Cud, Rr, Uu^Em, Cud, Uu, Rr, Rr, Uu, Rr, Uu, Rr, Rr, Ss, Ss, Re^Tf, Ss, Re^Tf, Xu, Xu, Xu
Xu, Xu, Xu, Xu, Xu, Xu, Xu, Xu, Xu, Xu, Xu, Xu, Xu, Xu, Uu^Tf, Rr, Rr, Cud, Cud, Cud, Rr, Rr, Uh, Uu, Qxu, Uu, Uu, Rr, Uu, Rr, Uu, Uu, Uu^Tf, Ss, Xu, Ss, Xu, Xu, Xu, Xu
Xu, Xu, Xu, Xu, Xu, Xu, Xu, Xu, Xu, Xu, Xu, Xu, Xu, Xu, Xu, Uu^Tf, Uu, Cud, Rr, Cud, Uu, Uh, Qxu, Qxu, Xu, Uu^Vu, Uu, Uh, Uh, Uu^Em, Xu, Uu^Tf, Xu, Xu, Xu, Xu, Xu, Xu, Xu, Xu
Xu, Xu, Xu, Xu, Xu, Xu, Xu, Xu, Xu, Xu, Xu, Xu, Xu, Xu, Xu, Xu, Xu, Uu, Uu^Vu, Uu, Xu, Xu, Qxu, Qxu, Qxu, Xu, Xu, Xu, Xu, Xu, Xu, Xu, Xu, Xu, Xu, Xu, Xu, Xu, Xu, Xu
Xu, Xu, Xu, Xu, Xu, Xu, Xu, Xu, Xu, Xu, Xu, Xu, Xu, Xu, Xu, Xu, Xu, Xu, Xu, Xu, Xu, Xu, Xu, Qxu, Xu, Xu, Xu, Xu, Xu, Xu, Xu, Xu, Xu, Xu, Xu, Xu, Xu, Xu, Xu, Xu
Xu, Xu, Xu, Xu, Xu, Xu, Xu, Xu, Xu, Xu, Xu, Xu, Xu, Xu, Xu, Xu, Xu, Xu, Xu, Xu, Xu, Xu, Xu, Xu, Xu, Xu, Xu, Xu, Xu, Xu, Xu, Xu, Xu, Xu, Xu, Xu, Xu, Xu, Xu, Xu
Xu, Xu, Xu, Xu, Xu, Xu, Xu, Xu, Xu, Xu, Xu, Xu, Xu, Xu, Xu, Xu, Xu, Xu, Xu, Xu, Xu, Xu, Xu, Xu, Xu, Xu, Xu, Xu, Xu, Xu, Xu, Xu, Xu, Xu, Xu, Xu, Xu, Xu, Xu, Xu
