Mm, Mm, Hh, Hh, Gd^Fdf, Gd^Fdf, Gd^Fdf, Gd^Fdf, Gd^Fdf, Rd, Gd, Gs, Gs, Ww, Ww, Ds, Ds, Gs, Gs, Gs, Gd, Gd, Gd, Re, Gd, Gd, Gd, Gd, Gd, Gd, Gs^Fdf, Hh, Mm, Mm, Mm, Hh, Mm, Hh, Hh
Mm, Mm, Hh, Hh, Gd^Fdf, Gd^Fdf, Gd^Fdf, Gd^Fdf, Gd^Fdf, Rd, Gd, Gs, Gs, Ww, Ww, Ds, Ds, Gs, Gs, Gs, Gd, Gd, Gd, Re, Gd, Gd, Gd, Gd, Gd, Gd, Gs^Fdf, Hh, Mm, Mm, Mm, Hh, Mm, Hh, Hh
Hh, Hh, Hh, Gs^Fdw, Gd^Fdf, Gd^Fdf, Gd, Gd, Gd, Rd, Gd, Gs, Gs, Ww, Ww, Ww, Ww, Gs, Gs, Gs, Gs, Gd, Gd, Re, Re, Gd, Re, Gd, Gd, Hh, Hh, Hh, Hh, Mm, Mm, Mm, Hh, Hh, Hh
Gd^Fdf, Gd^Fdf, Gs^Fdw, Gd^Fdf, Gs^Fdw, Gd^Fdf, Gd, Gd^Fdf, Gd, Rd, Gd, Gd, Gd, Gs^Fdf, Gs^Fdf, Ww, Ww, Ww, Ww, Gs, Gs, Gs, Gs, Gd, Gs, Re, Gs, Re, Gd, Gs^Fdf, Hh, Gs^Fdf, Gs^Fdf, Hh, Mm, Gd, Gd, Hh, Hh
Gs^Fdw, Gd^Fdf, Gd^Fdf, Gd^Fdf, Gs^Fdf, Gs^Fdf, Gd, Gd^Fdf, Gd^Fdf, Rd, Hh, Gd^Fdf, Gd^Fdf, Gd, Gs^Fdf, Gs^Fdf, Ds, Ww, Ww, Ds, Gs, Gs, Gs, Gs^Fdf, Gs^Fdf, Gs, Gs, Re, Gd, Gs^Fdf, Gd, Gd, Gd, Gs^Fdw, Hh, Hh, Gd, Hh, Hh
Re, Gd^Fdf, Gd^Fdw, Gs^Fdf, Gs^Fdf, Gs^Fdf, Gd, Gd, Gd, Rd, Rd, Gd^Vh, Gd, Gd, Gd, Gd, Gs^Fdf, Ww, Ww, Ds, Gs, Gd, Gd, Gs^Fdf, Gs^Fdf, Hh, Hh, Re, Re, Gd, Gd, Gd, Gd, Gs^Fdf, Gs^Fdf, Gs^Fdw, Gd, Gd, Gd
Gd^Fdf, Re, Re, Gs^Fdf, Gs^Fdf, Gd^Fdw, Hh, Hh, Hh, Gd^Fdw, Gd, Rd, Gd, Gd^Fdf, Gd^Fdf, Gd, Gs^Fdf, Ww, Ww, Ds, Gd, Gd, Gd^Vh, Gd, Gs^Fdf, Hh, Gs^Fdf, Gd, Gd, Re, Gd, Gd, Gd, Gd, Gd, Gd, Rr, Rr, Rr
Gd^Fdf, Gd^Fdw, Gd^Fdf, Re, Re, 2 Gs^Fdf, Gg^Fet, Gd^Fdf, Gs^Fdf, Gd, Gd^Fdf, Rd, Gd, Gd^Fdw, Gd, Gd, Gd, Ww, Ww, Ww, Ds, Gd, Gd, Gd, Gs^Fdf, Gs^Fdw, Gd, Gd, Re, Re, Gd, Gd, Gd, Gd, Rr, Rr, Re, Re, Re
Gd^Fdf, Gs^Fdw, Gs^Fdf, Gs^Fdf, Re, Gd^Fdw, Gs^Fdf, Gs^Fdf, Gs^Fdf, Gs^Fdw, Gd^Fdf, Rd, Rd, Gd, Gd, Gs^Fdf, Gd, Gd, Ww, Ww, Ds, Gd, Gd, Gd, Gd, Gd, Gd, Gd, Re, Gd, Re, Gd, Gd, Gd^Vh, Rr, Gd, Gd, Re, Re
Hh, Hh, Hh, Gs^Fdf, Re, Gd^Fdf, Gs^Fdf, Gs^Fdf, Gs^Fdf, Hh, Gd^Fdf, Gd^Fdw, Gd, Rd, Gd, Gd, Ww, Ww, Ww, Ww, Gd, Gd, Re, Re, Re, Gd, Gd, Gd, Gd, Re, Gd, Re, Rr, Rr, Gd, Gd, Gd, Gd, Gd
Gs^Fdf, Gs^Fdf, Re, Re, Gs^Fdf, Gd^Fdf, Gs^Fdf, Gs^Fdf, Gs^Fdf, Gs^Fdw, Gd^Fdf, Gd^Vh, Gd^Fdf, Rd, Rd, Gd, Ww, Ww, Ww, Ds, Gd, Re, Re, Re, Re, Re, Gd, Gd, Gd, Gd, Gd, Gd, Rr, Gd, Gd^Fdw, Gd, Gd, Gd, Gd
Re, Re, Re, Hh, Gs^Fdw, Gs^Fdf, Hh, Hh, Hh, Hh, Hh, Gs^Fdw, Gd^Fdf, Gd^Fdw, Rd, Gd, Ds, Ww, Ww, Ww, Ds, Gd, Gd, Re, Gd, Gd, Gd^Vh, Gd, Rr, Gd, Rr, Rr, Gd^Fdf, Gd, Gd, Gd, Gd, Gd, Gd
Gd^Fdf, Gd^Fdw, Re, Gd^Fdf, Gd^Fdf, Hh, Gs^Fdf, Hh, Hh, Mm, Hh, Hh, Gd^Fdw, Gd, Rd, Gd^Fdf, Gs^Vh, Ds, Ww, Ww, Ww, Gd, Ch, Gd, Rr, Rr, Rr, Rr, Gd, Rr, Gd, Gd, Gd^Fdw, Gd^Fdw, Gd^Fdw, Gd^Fdf, Gd, Gd^Fdw, Gs^Fdf
Gd^Fdf, Gd^Fdf, Re, Gd^Fdw, Gd^Fdf, Gd^Fdw, Gd^Fdw, Hh, Gd^Fdf, Hh, Gs^Fdw, Gs^Fdf, Gs^Fdf, Gd^Fdw, Gd, Rd, Rd, Gs, Gs, Ww, Ww, Ww, Ww^Bw/, Rr, Gd, Gd, Gd, Gd, Rd, Rd, Gs^Vh, Gd, Gs^Fdf, Gs^Fdf, Gd^Fdw, Gd, Gd^Fdw, Gs^Fdf, Gd^Fdw
Gd^Fdw, Gd^Fdw, Gd^Fdf, Re, Re, Gd^Fdw, Hh, Hh, Hh, Gd^Fdf, Gd^Fdf, Hh, Hh, Gd, Gd, Gd, Gs^Vh, Rd, Rd, Ch, Rr, Ww^Bw/, Ww, Ww, Ww, Gd, Gd, Gd, Rd, Gd, Gd, Gd, Gd, Gd^Fdw, Gs^Fdf, Gs^Fdf, Gd^Fdw, Gd^Fdw, Gs^Fdf
Gd^Fdf, Gd^Fdf, Gd^Fdw, Gd^Fdw, Re, Gs^Fdf, Gs^Fdf, Gd^Fdf, Gs^Fdw, Gs^Fdw, Gd^Fdf, Gd^Fdf, Hh, Gs^Vh, Gd, Gd, Gs, Ch, Gs^Vh, Rr, Rr, Rr, Ch, Ww, Wo, Ww, Gd, Gd, Rd, Gd, Gd, Gd, Gd^Fdw, Gd, Gs^Fdw, Gd, Gd, Gd, Gd
Gd^Fdf, Gd^Fdf, Gd^Fdf, Gd^Fdw, Re, Gs^Fdw, Gd^Fdf, Gd^Fdf, Gd^Fdf, Gd^Fdf, Gd^Fdf, Gd, Gd, Hh, Re, Gd, Gd, Ch, Rr, Rr, Rr, Ch, 1 Kh, Ww^Bw\, Wo, Ww, Gd, Rd, Gd, Gd, Gd, Gd, Hh, Hh, Mm, Gd, Hh, Gs^Fdw, Gs^Fdw
Gd^Fdf, Gd^Fdf, Gd^Fdw, Gd^Fdf, Gd^Fdw, Re, Gd^Fdw, Gd^Fdf, Gs^Fdw, Gs^Fdw, Gd, Gd^Fdf, Re, Re, Re, Re, Gs^Vh, Ch, Rr, Rr, Rr, Ch, Ch, Ww^Bw\, Wo, Ww, Ds, Rd, Gs^Vh, Gd, Gs^Fdw, Gs^Fdf, Gs, Mm, Mm, Mm, Mm, Hh, Hh
Gd^Fdw, Gd^Fdf, Gd^Fdf, Gd^Fdf, Re, Re, Gd^Fdf, Gd^Fdf, Gd^Fdf, Gd^Fdf, Gd^Fdf, Gd, Gd, Re, Gd, Gd, Rr, Rr, Ch, Rr, Gs^Vh, Rr, Rr, Ww^Bw\, Wo, Ww, Rd, Rd, Hh, Gd, Hh, Hh, Mm, Mm, Mm, Mm, Mm, Hh, Hh
Gd^Fdw, Gd^Fdf, Gd^Fdw, Re, Gd^Fdf, Gd^Fdw, Gd^Fdw, Gs, Gd^Fdf, Gd^Fdw, Gd, Gd, Gs^Fdf, Gd, Rr, Rr, Ce, Rd, Rd, Ch, Ch, Rr, Ww, Ww, Ww, Ww, Rd, Hh, Gs, Hh, Gs, Mm, Mm, Mm, Mm, Mm, Mm, Gs^Fdw, Gs^Fdw
Gd^Fdf, Gd^Fdf, Gd^Fdf, Re, Gd^Fdf, Gd^Fdf, Gs, Gd^Fdf, Gd, Gd, Gd, Gd, Gs^Vh, Gd, Rr, Ce, Gs, Rd, Rd, Rd, Gs^Fdf, Ww, Ww, Wo, Ww^Bw/, Gs, Rd, Gs^Vh, Gs, Hh, Gs, Mm, Hh, Hh, Aa^Fda, Hh, Hh, Hh, Hh
Gd^Fdf, Gs^Fdw, Gd^Fdf, Re, Re, Gd^Fdf, Re, Gs^Vh, Gs^Fdf, Gs^Fdw, Rd, Gs^Fdf, Rd, Gs^Fdw, Rr, Ce, Gs^Vh, Rd, Rd, Rd, Gs, Gs^Fdf, Ww, Wo, Ww, Gs, Gs, Rd, Gs, Gs, Gs, Hh, Aa^Fda, Hh, Hh, Aa^Fda, Ww, Ww, Ww
Gd^Fdf, Gs^Fdw, Gs^Fdw, Gs^Fdw, Gs^Fdf, Re, Gs^Fdf, Rd, Rd, Rd, Gs^Fdf, Rd, Gs^Fdw, Rr, Gs, Gs, Gs, Rd, Rd, Gs^Vh, Ww^Bw\, Ww^Bw\, Wo, Wo, Ww, Gs, Ww, Rd, Ww, Gs, Hh, Hh, Aa^Fda, Aa^Fda, Hh, Aa^Fda, Ww, Aa^Fda, Aa^Fda
Gs^Fdw, Gd^Fdf, Gs^Fdw, Gs^Fdf, Gs^Fdw, Gs, Gs^Fdw, Gs, Gs, Gs, Gs, Gs, Gs, Gs, Ww, Ww, Ww, Gs^Fdf, Gs^Vh, Gs, Ww^Bw\, Wo, Wo, Wo, Wo, Ww, Ds, Ww^Bw|, Ds, Ww, Ww, Aa^Fda, Aa^Fda, Aa^Fda, Ww, Ww, Aa^Fda, Aa^Fda, Aa^Fda
Gs^Fdf, Gs^Fdw, Gs^Fdf, Gs^Fdw, Gs^Fdf, Gs^Fdf, Gs, Gs, Ww, Ww, Ww, Gs, Ww, Ww, Ww, Ww, Ww, Ww, Ww, Ww, Wo, Wo, Wo, Wo, Ww, Ww, Rd, Rd, Gs, Gs, Ww, Aa^Fda, Aa^Fda, Aa^Fda, Ww, Aa^Fda, Aa^Fda, Aa^Fda, Aa^Fda
Gs^Fdf, Gs^Fdf, Gs^Fdw, Gs^Fdf, Ww, Gs^Fdf, Ww, Gs^Fdw, Ww, Ww, Ww, Ww, Ww, Ww, Ww, Ww, Ai, Ww, Ai, Ai, Ai, Ww, Ww, Ww, Gs^Vh, Rd, Gd, Gd, Gd, Gs, Aa^Fda, Ww, Ww, Ww, Aa^Fda, Aa^Fda, Aa^Fda, Aa^Fda, Aa^Fda
Gs^Fdf, Gs^Fdf, Ww, Ww, Ww, Ww, Ww, Ww, Ww, Ww, Ww, Gs^Fdf, Ww, Ww, Wo, Wo, Ai, Gs, Gd, Gd, Gd, Gs, Gs, Gs, Rd, Rd, Gd, Gd, Gd, Hh, Hh, Aa^Fda, Aa^Fda, Aa^Fda, Aa^Fda, Aa^Fda, Hh, Aa^Fda, Aa^Fda
Ww, Ww, Ww, Ww, Gd^Fdf, Ww, Hh, Ww, Gs^Fdf, Ww, Ww, Ww, Ww, Ww, Ai, Ai, Gd, Gd, Gd, Gd, Aa, Gd, Rd, Rd, Gd, Gd, Gd, Gd, Gd, Hh, Hh, Aa^Fda, Aa^Fda, Hh, Aa^Fda, Aa^Fda, Hh, Gg^Ve, Gg
Ww, Ww, Gs^Fdw, Gd^Fdf, Gs^Fdw, Gs^Fdw, Hh, Hh, Hh, Gs^Fdf, Hh, Ww, Ai, Ai, Aa, Aa, Gd, Gs, Re, Re, Aa, Rd, Aa^Vha, Aa, Aa, Gd, Gd, Gd, Hh, Hh, Wo, Mm, Mm, Hh, Hh, Hh, Ai, Aa^Fda, Aa^Fda
Gd^Fdf, Gd^Fdf, Gd^Fdf, Gd^Fdf, Gd^Fdf, Gd, Gs^Fdf, Hh, Hh, Hh, Gs, Gs, Ai, Aa, Aa^Vha, Re, Gd, Gd, Gd, Aa, Aa^Fda, Rd, Aa^Fda, Aa, Gd, Gd, Gd, Gd, Hh, Mm, Mm, Hh, Mm, Hh, Mm, Hh, Ha, Aa^Fda, Aa^Fda
Hh, Hh, Gd^Fdw, Gd^Fdw, Gd^Fdf, Gd^Fdw, Gd^Fdw, Hh, Gd, Hh, Hh, Gs, Ww, Gs, Aa, Aa, Gd, Gd, Aa^Fda, Hh, Ha, Rd, Gd^Fdw, Aa, Gd, Gd, Hh, Hh, Aa^Fda, Mm, Hh, Mm, Mm, Mm, Ha, Mm, Ha, Hh, Hh
Gs^Fdf, Gd^Fdw, Gs^Fdf, Gd^Fdw, Gd^Fdw, Gd, Gd^Fdw, Gd^Fdw, Gd, Gs^Fdf, Hh, Gs, Gs, Ai, Gs, Aa, Gd, Gd, Aa^Fda, Ha, Aa^Fda, Rd, Gd, Gd, Gd, Gs^Vh, Hh, Aa^Fda, Ai, Aa^Fda, Aa^Fda, Hh, Mm, Mm, Mm, Ha, Ha, Mm, Mm
Gs, Gs, Gs, Gd^Fdw, Gs^Fdf, Gd^Fdw, Gs^Fdf, Gs^Fdf, Gs^Fdw, Gd, Gd, Gd, Aa, Ss, Ai, Gd, Re, Re, Aa, Aa^Fda, Aa^Fda, Rd, Gd^Vh, Gd, Gd, Gd, Gd, Ai, Hh, Hh, Aa^Fda, Hh, Mm, Wo, Mm, Mm, Ha, Ha, Ha
Gs^Fdf, Gs^Fdw, Gs^Fdf, Re, Re, Gs, Gs, Gd, Gd, Gs^Fdf, Gs^Fdw, Aa, Aa, Aa, Re, Ai, Gd, Aa, Gd, Aa, Gd, Rd, Rd, Aa^Fda, Ha, Hh, Hh, Hh, Ha, Ai, Mm, Mm, Mm, Mm, Ha, Ha, Ha, Ha, Ha
Gs^Fdw, Gs^Fdw, Gs^Fdw, Gs^Fdw, Ss, Gs^Fdf, Ss, Gs^Fdf, Gs^Fdw, Re, Re, Aa, Re, Re, Ai, Ai, Gd, Gd, Gd, Gd, Gd, Gd, Rd, Aa^Fda, Ha, Aa^Fda, Aa^Fda, Ha, Ha, Hh, Hh, Mm, Mm, Ha, Aa^Fda, Aa^Fda, Ha, Aa^Fda, Aa^Fda
Gs^Fdf, Gs^Fdw, Gs^Fdw, Gs^Fdf, Gs^Fdw, Ss, Gs^Fdf, Gs^Fdw, Gs^Fdf, Gs^Fdf, Gs^Fdw, Re, Aa^Vha, Aa, Ss, Gs, Gs, Gs^Fdw, Hh, Gs^Fdf, Gd, Gd, Rd, Aa^Fda, Aa^Fda, Aa^Fda, Hh, Ha, Hh, Mm, Mm, Mm, Mm, Hh, Hh, Aa^Fda, Aa^Fda, Aa^Fda, Aa^Fda
Gs, Gs, Ss, Ss, Ss, Ss, Gs^Fdw, Gs, Gs^Fdw, Gd, Gd, Gd, Gd, Gs, Ai, Gs, Ww, Gs^Fdf, Gs^Fdw, Gs^Fdw, Gs^Fdf, Aa, Rd, Gd, Gd, Aa, Gd, Gd, Gd, Aa, Aa, Aa, Gd, Aa, Gd, Aa, Gd, Aa, Aa
Gs^Fdf, Gs^Fdw, Ss, Ss, Ss^Vhs, Gs, Gs^Fdf, Gs^Fdf, Gs^Fdf, Gs^Fdf, Gs^Fdw, Aa, Aa, Gd, Gd, Ai, Aa, Ai, Ai, Gs^Fdf, Gd, Rd, Aa, Gd, Aa^Fda, Gd, Hh, Aa, Gd, Gd, Gd, Gd, Aa^Fda, Gd, Gd, Gd, Gd, Gd, Gd
Gs^Fdf, Gs^Fdf, Ss, Ss, Ss, Gs, Gs^Fdw, Gs^Fdw, Gs^Fdw, Gs^Fdf, Gs^Fdf, Aa, Aa, Gd, Gd, Ai, Aa, Ai, Ai, Gs^Fdw, Gd, Rd, Aa, Aa, Aa^Fda, Gd, Hh, Aa, Gd, Gd, Gd, Gd, Aa^Fda, Gd, Gd, Gd, Gd, Gd, Gd
